--#########
--#.....  #
--### $ # ##
----# $##  #
----#$ $ $ #
----#   #  #
----##  # @#
-----#######