   ########
  ##..#   #
  # ..# $ ##
  # @ $  $ #
  ##$###   #
   #     ###
   #######