   #######
   #     ####
   # ###.   #
  ##    # # #
  # .#$ $ # #
  # #  *  # #
  # # $ $#. #
  # # #    ##
  #   .### ##
  ####      #
     #####  #
         #@ #
         ####